R 1070 840
NO textures/redbrick.xpm
SO textures/green_tex.xpm
WE textures/new_xpm.xpm
EA textures/write_tex.xpm
S textures/barrel.xpm
F 20 50 90
C 20 50 90

111111111111111111111111111111111
11111111111000000000020000000N001
120000000000000000000000000000011
111111111110000000000000000000001
120000000000000000000000000000011
120000000000000000000000000000001
120000000000010000000000000000021
111111111110000000000000111111111
110011111110000000000000000000021
111011111100002000000000000000001
111111100000020000200100000000021
111111111111111111111111111111111