R 1200 840
NO textures/no.xpm
SO textures/south.xpm
WE textures/west.xpm
EA textures/east.xpm
S textures/barrel.xpm
K textures/pillar.xpm
F 125 43 222
C 125 125 222

111111111111111111111111111111111
111111111110000000000200000000001
11200000000000000000000000000W011
111111111110000000000000000000001
112000000000000000000000000000001
112000000000000000000000000000001
112000000000001000000000000000001
111111111110000000000000111111111
110011111110000000000000000000021
111011111100000000000000000000001
111111100000020000200100000000021
111111111111111111111111111111111